00000000
10101010
00000000
01010101
00000000
04002020
20200400
00000000
02020040
00400202
00000000
00000000
00000000
03300330
00033000
00000000
00000000
00000000
00000000
00000000
00000000
00000000