30300303
00000000
04044040
00000000
00000030
00000303
00003000
00030000
00300000
33000000
00000000
40000000
20000110
22111004
22200002
00000002
11000220
11001220
00001000
00001000
01011000
11000000