00000000
00000000
00000000
00000000
01111110
00000000
00000000
00000000
04000040
00000000
00000000
00000000
02222220
00000000
00000000
00000000
00000000
00000000
00000000
00000000
00000000
00000000